1;1;X;2;2;1;N
1;1;X;2;CC;1;CN
1;1;X;2;2;2;2
1;1;X;1;1;1;N
N;1;1;1;X;X;3
1;C;1;P;1;1;3